WWWWWWWWWWWWWWWWWWWW
W........WW........W
W.WWWW.WW.WW.WWWW.W
W*W   W.WW.WW.W   W*W
W.WWWW.WW.WW.WWWW.W
W..................W


W........WW........W
W.WWWW.WW.WW.WWWW.W
W*W   W.WW.WW.W   W*W
W.WWWW.WW.WW.WWWW.W
W..................W

W........WW........W
W.WWWW.WW.WW.WWWW.W
W*W   W.WW.WW.W   W*W
W.WWWW.WW.WW.WWWW.W
W..................W
WWWWWWWWWWWWWWWWWWWW